111111111111111
10010000000C001
100C011111000M1
1P0011E0000C001
111111111111111
