1111111111
10C0000M01
10C1100C01
1P00100CE1
1111111111