111111111111111
100001000000001
100001000000001
100001000M00001
1P0001000C000E1
111111111111111
